================
================
================
===           ==
=== IIIIIII   ==
===       i   ==
===  F F Fi=  ==
===  = = =i M===
==== = = =i=====
===       iF====
=== = = ========
===F=F=F========
================
================