================
=              =
=              =
=  ==========  =
=  ===  =  ==  =
=  ===   M===  =
=  ===  =====  =
=  ==     ===  =
=  =====  ===  =
=  ===== F===  =
=  ==========  =
=              =
=              =
================