================
=   ========   =
=  ==========  =
= ====     === =
= ==    F  === =
= ===   III=== =
= ====M   ==== =
= ===== =i==== =
= ===F   i F== =
=  =========   =
=   =======    =
=              =
================