================
================
================
===       ======
==    F M  =====
==   =II=   ====
=   ==  ==   ===
=  ===  ===   ==
==I===  ====  ==
==   IIII ===  =
==   ====     ==
================
================
================