================
=              =
= ============ =
= ====      == =
= ==   == M == =
= ==   ===I=== =
= =     ==  == =
= =  ==      = =
= =   = F    = =
= ===F=F====F= =
= ============ =
=              =
=              =
================