================
=              =
=              =
=   ========   =
=   =  ==  =   =
=   ==     =   =
=   == M= F=   =
=   =  == ==   =
=   =     ==   =
=   =F==F ==   =
=   ========   =
=              =
=              =
================