================
=              =
= ============ =
= ===      === =
= ==    M F == =
= ==F  ==II == =
= === F =   == =
= ====II   === =
= ====    ==== =
= ==== ======= =
= ==== ======= =
= ============ =
=              =
================