================
=              =
=    ======    =
=    =    =    =
=    =   F=    =
=    =iIIi=    =
=    =F  M=    =
=    =iIIi=    =
=    =i  F=    =
=    =iIIi=    =
=    =F  i=    =
=    ======    =
=              =
================