################
################
################
####        ####
####  f i m ####
#### ###########
#### i   #######
#### i f    ####
#### i f    ####
#### i f    ####
#########f  ####
################
################
################