================
================
================
====        ====
====  F I M ====
==== ===========
==== I   =======
==== I F    ====
==== I F    ====
==== I F    ====
=========F  ====
================
================
================
