================
================
================
================
================
==     = IIII ==
==      = IF  ==
==MI F= = IF  ==
=======   IFF ==
================
================
================
================
================
