================
================
================
===          ===
==  I         ==
==  ==  F I   ==
==  == IF I M ==
==  ============
==  =====  =====
==        F=====
================
================
================
================
