################
################
################
###          ###
##  i         ##
##  ##  f i   ##
##  ## if i m ##
##  ############
##  #####  #####
##        f#####
################
################
################
################