================
================
================
================
===          ===
===          ===
===iI      Ii===
===FIII  IIIF===
====F IIII F====
=====FIM IF=====
================
================
================
================
