================
================
================
================
===          ===
===          ===
===II      II===
===fIII  IIIf===
====f IIII f====
=====fIM If=====
================
================
================
================
