################
################
################
################
###          ###
###          ###
###ii      ii###
###fiii  iiif###
####f iiii f####
#####fim if#####
################
################
################
################