================
================
================
====    ========
===       ======
===I        ====
===i=         ==
=== ==        ==
=== == I I    ==
=== ====== M ===
=== ======III===
===F======III===
================
================
