================
================
================
====    ========
===       ======
===i        ====
===I=         ==
=== ==        ==
=== == I I    ==
=== ====== M ===
=== ======III===
===F======III===
================
================
