================
================
================
===       =  ===
===       = M===
=== I     ==i===
===i==       ===
===  = I I I ===
===F ===========
==IIIIIIIIIII===
===          ===
===FFFFFFFFFF===
================
================
