================
================
================
====        ====
====     IM ====
====  F IIII====
======I=========
=====      =====
=====      =====
=========  =====
=======F  ======
=======FFF======
================
================
