################
################
################
####        ####
####     im ####
####  f iiii####
######i#########
#####      #####
#####      #####
#########  #####
#######f  ######
#######fff######
################
################