################
################
################
#####      #####
####        ####
#### i    f ####
#######m #i#####
########## #####
####f       ####
####iiiiiii ####
####ffffffii####
################
################
################