================
================
================
=====      =====
====        ====
==== I    F ====
=======M =I=====
========== =====
====F       ====
====IIIIIII ====
====FFFFFFII====
================
================
================
