================
================
================
===========   ==
== MI         ==
==IIIIIIIIII====
==F        F====
===F      F=====
====F    F======
=====F  F=======
======FF========
================
================
================
