================
=              =
=              =
=  ==========  =
=  ====  ====  =
=  ===    ===  =
=  === M  ===  =
=  =   ==   =  =
=  =   ==III=  =
=  =F=====F==  =
=  ==========  =
=              =
=              =
================