================
=              =
=          M   =
=   ==    F=   =
= ===  =  ==  ==
=   ==  =  =   =
=   =  =  =  = =
==   =    =  F =
=   F=  =  === =
=  ==  =  ==   =
=    =  =  =  F=
==F    ===    ==
===   ====   ===
================