================
================
================
=======   ======
=======FFFM=====
=======IIII=====
=====      =====
===   =   ======
===   ==========
=== F         ==
=========i   F==
================
================
================