================
================
================
===       ======
=== M     ======
======  F=  ====
====== ==   ====
=====  ===  F===
=====       ====
=======F========
================
================
================
================