================
=              =
=              =
=  ==========  =
=  ===    ===  =
=  === M  ===  =
=  === =  ===  =
=  ===   iF==  =
=  ===  F====  =
=  ==========  =
=  ==========  =
=              =
=              =
================