================
==            ==
=    ======    =
======    ======
=====  M   =====
====   i    ====
====  ===   ====
====    =  =====
=====F =   =====
======F= F======
========F=======
=    ======    =
==            ==
================