================
=              =
=  ==========  =
= ============ =
= ======    == =
= ===     = == =
= ==  =  == == =
= ==  ==M = == =
= ===   =   == =
= ===  F=F  == =
= ====F===F=== =
=  ==========  =
=              =
================
