================
================
==            ==
== ========== ==
== ==       = ==
== ==   =IM = ==
== ==   = II= ==
== == = = i = ==
== = i i  i = ==
== =F======== ==
== ========== ==
==            ==
================
================