================
================
=======    =====
===      M  ====
=== ===  ==   ==
===  F i   =  ==
==== ==I =   ===
====     F =====
======= I=======
======= F=======
================
================
================
================