================
================
=====    =======
=====     ======
=====     ==   =
===   = M = F  =
===  =====III  =
== F           =
== =============
==      ========
=======I  ======
=======  F =====
================
================