================
================
=====       ====
====   M     ===
===  ======   ==
==  =      =  ==
== IIII =   = ==
===I  =F=  =  ==
====I ==  =  ===
=====I   =  ====
=====      =====
=====F==========
================
================