================
================
================
====     I F====
====I  =========
====  I=========
====I   MI F====
====   =========
====   =========
====   =========
==== F     F====
================
================
================
