================
================
================
====     I F====
====i  =========
====  i=========
====i   MI F====
====   =========
====   =========
====   =========
==== F     F====
================
================
================
