################
################
################
####     i f####
####i  #########
####  i#########
####i   mi f####
####   #########
####   #########
####   #########
#### f     f####
################
################
################