================
================
================
====     i F====
====I  =========
====  I=========
====I   Mi F====
====   =========
====   =========
====   =========
==== F     F====
================
================
================
