================
================
===           ==
===M  i  F II ==
====I ======= ==
============= ==
===        == ==
===        == ==
===     =   = ==
====   ===    ==
====   ==   = ==
====FFF===   F==
================
================
