================
================
================
==   ====     ==
==iI        iF==
== ==      ==I==
== ==F M i == ==
== ========== ==
==            ==
== IIIIIIIIII ==
==Fi FFFFFF F ==
====F======F====
================
================