================
================
================
====        ====
==== IIIIII ====
==== i  FFF=====
==== i  ========
=======    =====
===     =  =====
===F      =  ===
=====  === M ===
=====      I====
================
================