================
================
================
===     ========
=== M=  ========
====Ii= ========
=====   =    ===
===== ==     ===
===== =  =  F===
=====F  ==I=====
========== =====
==========F=====
================
================