================
================
===         ====
===I        ====
=== ====    ====
=== ==  =    ===
=== ==   =  F===
=== ===     ====
=== ====  ======
=== ==  =    ===
=== ==   =  F===
===F==Mi    ====
================
================