================
================
================
===  =  ========
==   =F ========
==  =II M   i=== 
==      = ==I ==
======I== i  F==
=========== ====
=========== ====
===========F====
================
================
================