================
================
================
================
================
====        ====
====   M    ====
=====I===I  ====
====   ==  =====
====Fi ==   F===
================
================
================
================