================
================
======    ======
=====     ======
===== M =   ====
======= =  F====
=======F=I======
========= ======
======   F======
======   =======
====== = =======
===Fi   F=======
================
================