##################
##################
##################
####          ####
####    f i g ####
#### #############
#### i   #########
#### i f      ####
#### i f      ####
#### i f      ####
######### f   ####
##################
##################
##################