##################
##################
##################
##################
###     # iiii ###
###      # if  ###
###gi f# # if  ###
########   iff ###
##################
##################
##################
##################
##################