================
================
==            ==
== ========== ==
== ==      == ==
== ==      == ==
== == IIii == ==
== == i  =F== ==
== ==III  === ==
== ==F iM==== ==
== ========== ==
==            ==
================
================