================
================
================
===       ======
==          ====
==    =       ==
====I===      ==
==     = i iM ==
==     =I=======
==     =  ======
== F F =F ======
================
================
================