================
================
===           ==
====        i ==
== =II II F== ==
==   i i  === ==
== ======  == ==
===  ==   === ==
====  II  === ==
==   ====  == ==
=== II II F== ==
==   iMi  ===F==
================
================