================
================
================
====    ========
=====   ==   === 
======M ==   ===
======= F   ====
======= =  =====
=======   ======
=======   ======
========= ======
=========F======
================
================