================
=              =
= ============ =
= ============ =
= ====    ==== =
= ====  =   F= =
= ==   = M  == =
= =   i I== == =
= ==  =     == =
= ==    I===== =
= =====F====== =
= ============ =
=              =
================