================
==            ==
=  ==========  =
= ============ =
= ====    ==== =
= ====    ==== =
= =   M=F=   = =
= =   = i =  = =
= =  =  i    = =
= ==   =i===== =
= ============ =
=  ==========  =
==            ==
================