================
=              =
=              =
=  ==========  =
=  =      ===  =
=  = = ==M F=  =
=  =  i  ====  =
=  ====I  = =  =
=  ====FiFiF=  =
=  ==========  =
=  ==========  =
=              =
=              =
================