================
================
==            ==
==       =   ===
==      ==F   ==
==     = FIIIF==
==   =   IIIIi==
==     = =    ==
==    = M=======
==   i II  =====
==  ====   =====
==         =====
================
================