================
================
==            ==
== ========== ==
== =====   == ==
== ==== iM == ==
== ===  =I == ==
== ==    II== ==
== == = == == ==
== == F  i == ==
== ========== ==
==            ==
================
================