################
################
################
################
################
##     # iiii ##
##      # if  ##
##mi f# # if  ##
#######   iff ##
################
################
################
################
################