################
################
################
####    ########
###       ######
###i        ####
###i#         ##
### ##        ##
### ## i i    ##
### ###### m ###
### ######iii###
###f######iii###
################
################