################
################
################
###       #  ###
###       # m###
### i     ##i###
###i##       ###
###  # i i i ###
###f ###########
##iiiiiiiiiii###
###          ###
###ffffffffff###
################
################