################
################
################
###########   ##
## mi         ##
##iiiiiiiiii####
##f        f####
###f      f#####
####f    f######
#####f  f#######
######ff########
################
################
################